11111111111111111111
1P00000C0000C0010001
11111111111111001001
100C0011111111C00001
10000110C00000C01111
100C0000000C00010001
11111111111100C00001
100C0000000C001000E1
11111111111111111111