111111111111111111111
1C100101C0C100101C1C1
100C1C0C00100C1C0C0E1
111C01C101001C01C1011
10001000C010001000C01
1C10C0101C0C10C0101C1
1C100101C0C100101C1C1
100C1C0C00100C1C0C0C1
111C01C101001C01C1011
10001000C010001000C01
1P10C0101C0C10C0101C1
111111111111111111111
