1111111111111111111
100P00E000C00111111
1111111111111111111