1111111111111111111
1C000000C0000111111
1001000000000001111
10010000E0000P01111
1001000000000C11111
100000T0000000000C1
1111111111111111111