1111111111111111111
100000C000000111111
1001000000000001111
1001000000000001111
10010000P0000011111
100000T000000000001
1111111111111111111