1111111111111111111
10000000C0000001111
1001010000000001111
10010000E0000P01111
1001000000000C01111
10000000001100000C1
1111111111111111111