1111111111111111111
100P000C1000CE11111
1111111111111111111