11111111
10P00E01
100C0T01
11111111