111111111111111111111
10P0C0C0C00000C0C0CE1
111111111111111111111